Abigail	Szalaj	abigail.szalaj@webtutorialnashville.com	Active
Abram	Haynes	abram.haynes@webtutorialnashville.com	Active
Adam	Brown	adam.brown@webtutorialnashville.com	Active
Adam	Nunley	adam.nunley@webtutorialnashville.com	Active
Adeline	Vick	adeline.vick@webtutorialnashville.com	Active
Aidan	Hanna	aidan.hanna@webtutorialnashville.com	Active
Alexander	Mumpower	xander.mumpower@webtutorialnashville.com	Active
Alizah	Milfred	alizah.milfred@webtutorialnashville.com	Active
Alyssa	Johnson	alyssa.johnson@webtutorialnashville.com	Active
Alyssa	Hayes	alyssa.hayes@webtutorialnashville.com	Active
Amelie	Oakes	amelie.oakes@webtutorialnashville.com	Active
Andrew	Wolff	andrew.wolff@webtutorialnashville.com	Active
Angelina	Dilks	lina.dilks@webtutorialnashville.com	Active
Asher	Smith	asher.smith@webtutorialnashville.com	Active
Aslan	Clo	aslan.clo@webtutorialnashville.com	Active
Atticus	McMahon	atticus.mcmahon@webtutorialnashville.com	Active
Avery	Foster	avery.foster@webtutorialnashville.com	Active
AydenLove	Campbell	aydenlove.campbell@webtutorialnashville.com	Active
Beatrice	Troxel	bea.troxel@webtutorialnashville.com	Active
Becky	Gore	becky.gore@webtutorialnashville.com	Active
Becky	Sekeres.	becky.sekeres@webtutorialnashville.com	Active
Bella	Higginbotham	bella.higginbotham@webtutorialnashville.com	Active
Ben	Goodgame	ben.goodgame@webtutorialnashville.com	Active
Braige	Roley	braige.roley@webtutorialnashville.com	Active
Brian	Donohue	brian.donohue@webtutorialnashville.com	Active
Brooklynn	Johnson	brooklynn.johnson@webtutorialnashville.com	Active
Caitlin	Girard-Clark	caitlin.girardclark@webtutorialnashville.com	Active
Callum	Jones	callum.jones@webtutorialnashville.com	Active
Cameron	Simons	cameron.simons@webtutorialnashville.com	Active
Caraline	Cathcart	caraline.cathcart@webtutorialnashville.com	Active
Carla	Diaz	carla.diaz@webtutorialnashville.com	Active
Casey	McDougal	casey.mcdougal@webtutorialnashville.com	Active
Chapel	Andrus	chapel.andrus@webtutorialnashville.com	Active
Charles	Key	charles.key@webtutorialnashville.com	Active
Charlie	Koltis	charlie.koltis@webtutorialnashville.com	Active
Christopher	Stafford	christopher.stafford@webtutorialnashville.com	Active
Coen	Kice	coen.kice@webtutorialnashville.com	Active
Colin	Mumpower	colin.mumpower@webtutorialnashville.com	Active
Danilo	Ruiz	danny.ruiz@webtutorialnashville.com	Active
Dantae	Theory	dantae.theory@webtutorialnashville.com	Active
Dawn	Ruiz.	dawn.ruiz@webtutorialnashville.com	Active
Dean Coltrane	Abernathy	trane.abernathy@webtutorialnashville.com	Active
Declan	Benson	declan.benson@webtutorialnashville.com	Active
Declan	Brookshire	declan.brookshire@webtutorialnashville.com	Active
Devan	Reilly	devan.reilly@webtutorialnashville.com	Active
Duncan	Nelson	duncan.nelson@webtutorialnashville.com	Active
Eamon Grey Northridge	Norris	eamon.norris@webtutorialnashville.com	Active
Eliza	Bell	eliza.bell@webtutorialnashville.com	Active
Elizabeth	Bills	elizabeth.bills@webtutorialnashville.com	Active
Ella	Aldridge	ella.aldridge@webtutorialnashville.com	Active
Ella	Lapsley	ella.lapsley@webtutorialnashville.com	Active
Ella Grey	Milfred	ella.grey@webtutorialnashville.com	Active
Elliot	Dalton	elliot.dalton@webtutorialnashville.com	Active
Elsa	Netsch	elsa.netsch@webtutorialnashville.com	Active
Emma	Brozik	emma.brozik@webtutorialnashville.com	Active
Evan	Smith	evan.smith@webtutorialnashville.com	Active
Evelyn	Szalaj	evelyn.szalaj@webtutorialnashville.com	Active
Finley	McMahon	finley.mcmahon@webtutorialnashville.com	Active
Finn	Lowell	finn.lowell@webtutorialnashville.com	Active
Flore	Grunwald	flore.grunwald@webtutorialnashville.com	Active
Frances Adeline Nunley	Norris	adie.norris@webtutorialnashville.com	Active
Franky	Painter	franky.painter@webtutorialnashville.com	Active
Fred	Booth	fred.booth@webtutorialnashville.com	Active
Gabe	Crumby	gabe.crumby@webtutorialnashville.com	Active
Gerrick	Gann	gerrick.gann@webtutorialnashville.com	Active
Grace	Brown	grace.brown@webtutorialnashville.com	Active
Grey	Dominguez	grey.dominguez@webtutorialnashville.com	Active
Gwendolyn	JohnsonReid	gwendolyn.johnsonreid@webtutorialnashville.com	Active
Hector	DeFelice	hector.defelice@webtutorialnashville.com	Active
Henry	James	henry.james@webtutorialnashville.com	Active
Henry	Edwards	henry.edwards@webtutorialnashville.com	Active
Hewan	Bratcher	hewan.bratcher@webtutorialnashville.com	Active
Holden	Masters	holden.masters@webtutorialnashville.com	Active
Huck	Paisley	huck.paisley@webtutorialnashville.com	Active
Ivey	Netsch	ivey.netsch@webtutorialnashville.com	Active
Jack	Mathis	jack.mathis@webtutorialnashville.com	Active
Jake	Wilkison	jake.wilkison@webtutorialnashville.com	Active
James	Campbell	mason.campbell@webtutorialnashville.com	Active
Jasmine	Boner	jasmine.boner@webtutorialnashville.com	Active
Jasper	Paisley	jasper.paisley@webtutorialnashville.com	Active
Jasper	Kaloi	jasper.kaloi@webtutorialnashville.com	Active
Jax	Bledsoe	jax.bledsoe@webtutorialnashville.com	Active
Jenny	Conatser	jenny.conatser@webtutorialnashville.com	Active
Jilah	Kalil	jilah.kalil@webtutorialnashville.com	Active
JohnSimon	Sekeres	johnsimon.sekeres@webtutorialnashville.com	Active
Jolene	Dailey	jolene.dailey@webtutorialnashville.com	Active
Jonah	Goodgame	jonah.goodgame@webtutorialnashville.com	Active
Josephine	LeVasseur	josephine.levasseur@webtutorialnashville.com	Active
Judah	Bennett	judah.bennett@webtutorialnashville.com	Active
Kai	Bledsoe	kai.bledsoe@webtutorialnashville.com	Active
Kelby	Williams	kelby.williams@webtutorialnashville.com	Active
Lauren	Beihoffer	lauren.beihoffer@webtutorialnashville.com	Active
Leslie	Lutz	leslie.lutz@webtutorialnashville.com	Active
Leslie	Near	leslie.near@webtutorialnashville.com	Active
Liam	Brookshire	liam.brooksire@webtutorialnashville.com	Active
Liam	Hancock	liam.hancock@webtutorialnashville.com	Active
Liam	Conran	liam.conran@webtutorialnashville.com	Active
Lili	Near	lili.near@webtutorialnashville.com	Active
Lily	Conatser	lily.conatser@webtutorialnashville.com	Active
Lily	Sekeres	lily.sekeres@webtutorialnashville.com	Active
Lily	Cathcart	lily.cathcart@webtutorialnashville.com	Active
Luca	Rollings	luca.rollings@webtutorialnashville.com	Active
Lucia	Freitas	lucia.freitas@webtutorialnashville.com	Active
Lucia	Dickinson	lucia.dickinson@webtutorialnashville.com	Active
Lucy	Leventis	lucy.leventis@webtutorialnashville.com	Active
Luella	Gray	ella.gray@webtutorialnashville.com	Active
Lynk	Gibson	lynk.gibson@webtutorialnashville.com	Active
Maggie	Guess	maggie.guess@webtutorialnashville.com	Active
Maggie	Smith	maggie.smith@webtutorialnashville.com	Active
Mary Beth	West	mary.west@webtutorialnashville.com	Active
Matt	Wilkins	matt.wilkins@webtutorialnashville.com	Active
Matthew	Smith	matthew.smith@webtutorialnashville.com	Active
Maya	Fowler	maya.fowler@webtutorialnashville.com	Active
Maya	Reilly	maya.reilly@webtutorialnashville.com	Active
Miller	Campbell	miller.campbell@webtutorialnashville.com	Active
Mimi	Michel	mimi.michel@webtutorialnashville.com	Active
Mina	Claire	mina.claire@webtutorialnashville.com	Active
Mollie	Bowers	mollie.bowers@webtutorialnashville.com	Active
Morgandy	GirardClark	morgandy.girardclark@webtutorialnashville.com	Active
Nathan	Williams	nathan.williams@webtutorialnashville.com	Active
Noah	Roggendorff	noah.roggendorff@webtutorialnashville.com	Active
Noelle	Bennett	noelle.bennett@webtutorialnashville.com	Active
Norah	Spradling	norah.spradling@webtutorialnashville.com	Active
Oliver	Edwards	oliver.edwards@webtutorialnashville.com	Active
Panama	Landes	panama.landes@webtutorialnashville.com	Active
Paxton	Griffith	paxton.griffith@webtutorialnashville.com	Active
Preston	Cantrell	preston.cantrell@webtutorialnashville.com	Active
Rachel	Miltner	rachel.miltner@webtutorialnashville.com	Active
Raina	Foster	raina.foster@webtutorialnashville.com	Active
Rainer	Rebstock	rainer.rebstock@webtutorialnashville.com	Active
Rowan	Near	rowan.near@webtutorialnashville.com	Active
Rowena	Aldridge	rowena.aldridge@webtutorialnashville.com	Active
Sample	Student	sample.student@webtutorialnashville.com	Active
Scarlett	Nelson	scarlett.nelson@webtutorialnashville.com	Active
Senae	Smith.	senae.smith@webtutorialnashville.com	Active
Sera	Oakes	sera.oakes@webtutorialnashville.com	Active
Shannon	Dilks	shannon.dilks@webtutorialnashville.com	Active
Shannon	Truss	shannon.truss@webtutorialnashville.com	Active
Shannon	Truss	shannon@webtutorialnashville.com	Active
Shira	Boner	shira.boner@webtutorialnashville.com	Active
Silas	Spradling	silas.spradling@webtutorialnashville.com	Active
Simeon	Page	simeon.page@webtutorialnashville.com	Active
Sophie	Hollis	sophie.hollis@webtutorialnashville.com	Active
SparrowJane	Lucca	sparrowjane.lucca@webtutorialnashville.com	Active
Stella	Brown	stella.brown@webtutorialnashville.com	Active
Teddy	James	teddy.james@webtutorialnashville.com	Active
teddy	orendorff	teddy.orendorff@webtutorialnashville.com	Active
Thomas	Stafford	thomas.stafford@webtutorialnashville.com	Active
Tucker	Fowler	tucker.fowler@webtutorialnashville.com	Active
web	registration	registration@webtutorialnashville.com	Active
Wilder	Andrus	wilder.andrus@webtutorialnashville.com	Active
Willow	Andrus	willow.andrus@webtutorialnashville.com	Active
Wyatt	Zebroski	wyatt.zebroski@webtutorialnashville.com	Active
Yohannes	Armstrong	yohannes.armstrong@webtutorialnashville.com	Active
